Kalah Roche vs. Pokemon SSE,pokemon,D_HP,D_ATK,D_DEF,D_SPA,D_SPD,D_SPE,D_BST,SSE
0,Bulbasaur,-29,-44,-37,5,2,-58,-161,33460
1,Ivysaur,-14,-31,-23,20,17,-43,-74,9700
2,Venusaur,6,-11,-3,40,37,-23,46,5780
3,Venusaur (Mega Venusaur),6,7,37,62,57,-23,146,30392
4,Charmander,-35,-41,-43,0,-13,-38,-170,35268
5,Charmeleon,-16,-29,-28,20,2,-23,-74,8290
6,Charizard,4,-9,-8,49,22,-3,55,6080
7,Charizard (Mega Charizard X),4,37,25,70,22,-3,155,31428
8,Charizard (Mega Charizard Y),4,11,-8,99,52,-3,155,36740
9,Squirtle,-30,-45,-21,-10,1,-60,-165,34292
10,Wartortle,-15,-30,-6,5,17,-45,-74,8976
11,Blastoise,5,-10,14,25,42,-25,51,5936
12,Blastoise (Mega Blastoise),5,10,34,75,52,-25,151,33036
13,Caterpie,-29,-63,-51,-40,-43,-58,-284,94880
14,Metapod,-24,-73,-31,-35,-38,-73,-274,89940
15,Butterfree,-14,-48,-36,30,17,-33,-84,13130
16,Weedle,-34,-58,-56,-40,-43,-53,-284,94570
17,Kakuna,-29,-68,-36,-35,-38,-68,-274,89130
18,Beedrill,-9,-3,-46,-15,17,-28,-84,10560
19,Beedrill (Mega Beedrill),-9,57,-46,-45,17,42,16,9780
20,Pidgey,-34,-48,-46,-25,-28,-47,-228,61178
21,Pidgeotto,-11,-33,-31,-10,-13,-32,-130,20364
22,Pidgeot,9,-13,-11,10,7,-2,0,524
23,Pidgeot (Mega Pidgeot),9,-13,-6,75,17,18,100,16524
24,Rattata,-44,-37,-51,-35,-28,-31,-226,59952
25,Rattata (Alolan Rattata),-44,-37,-51,-35,-28,-31,-226,59952
26,Raticate,-19,-12,-26,-10,7,-6,-66,5722
27,Raticate (Alolan Raticate),1,-22,-16,-20,17,-26,-66,6462
28,Spearow,-34,-33,-56,-29,-32,-33,-217,55424
29,Fearow,-9,-3,-21,1,-2,-3,-37,1914
30,Ekans,-39,-33,-42,-20,-9,-48,-191,43640
31,Arbok,-14,2,-17,5,16,-23,-31,2260
32,Pikachu,-39,-38,-46,-10,-13,-13,-159,30800
33,Pikachu (Partner Pikachu),-29,-13,-36,15,-3,17,-49,5230
34,Raichu,-14,-3,-31,30,17,7,6,2440
35,Raichu (Alolan Raichu),-14,-8,-36,35,22,7,6,3350
36,Sandshrew,-24,-18,-1,-40,-33,-63,-179,39600
37,Sandshrew (Alolan Sandshrew),-24,-18,4,-50,-28,-63,-179,40210
38,Sandslash,1,7,24,-15,-8,-38,-29,3200
39,Sandslash (Alolan Sandslash),1,7,34,-35,2,-38,-29,4720
40,Nidoran♀,-19,-46,-34,-20,-23,-62,-204,50022
41,Nidorina,-4,-31,-19,-5,-8,-47,-114,16632
42,Nidoqueen,16,-1,1,15,22,-27,26,2372
43,Nidoran♂,-28,-36,-46,-20,-23,-53,-206,50370
44,Nidorino,-13,-21,-29,-5,-8,-38,-114,15980
45,Nidoking,7,9,-9,25,12,-18,26,1980
46,Clefairy,-4,-48,-38,0,2,-68,-156,32728
47,Clefable,21,-23,-13,35,27,-43,4,4958
48,Vulpix,-36,-52,-46,-10,2,-38,-180,40064
49,Vulpix (Alolan Vulpix),-36,-52,-46,-10,2,-38,-180,40064
50,Ninetales,-1,-17,-11,21,37,-3,26,2906
51,Ninetales (Alolan Ninetales),-1,-26,-11,21,37,6,26,3320
52,Jigglypuff,41,-48,-66,-15,-38,-83,-209,60580
53,Wigglytuff,66,-23,-41,25,-13,-58,-44,12660
54,Zubat,-34,-48,-51,-30,-23,-48,-234,64550
55,Golbat,1,-13,-16,5,12,-13,-24,1340
56,Oddish,-29,-43,-31,15,2,-73,-159,34490
57,Gloom,-14,-28,-16,25,12,-63,-84,13030
58,Vileplume,1,-13,-1,50,27,-53,11,6330
59,Paras,-39,-23,-31,-15,-8,-78,-194,47020
60,Parasect,-14,2,-6,0,17,-73,-74,11330
61,Venonat,-14,-38,-36,-20,-8,-58,-174,37040
62,Venomoth,-4,-28,-26,30,12,-13,-29,3530
63,Diglett,-64,-38,-61,-25,-18,-8,-214,56070
64,Diglett (Alolan Diglett),-64,-38,-56,-25,-18,-13,-214,55590
65,Dugtrio,-39,7,-36,-10,7,17,-54,6220
66,Dugtrio (Alolan Dugtrio),-39,7,-26,-10,7,7,-54,5360
67,Meowth,-34,-48,-51,-20,-23,-13,-189,42880
68,Meowth (Alolan Meowth),-34,-58,-51,-10,-23,-13,-189,43640
69,Meowth (Galarian Meowth),-24,-28,-31,-20,-23,-63,-189,42940
70,Persian,-9,-23,-26,5,2,12,-39,2980
71,Persian (Alolan Persian),-9,-33,-26,15,2,12,-39,3740
72,Psyduck,-24,-41,-38,5,-13,-48,-159,31480
73,Golduck,6,-11,-8,35,17,-18,21,2500
74,Mankey,-34,-13,-51,-25,-18,-33,-174,36240
75,Primeape,-9,12,-26,0,7,-8,-24,1590
76,Growlithe,-19,-23,-41,10,-13,-43,-129,21330
77,Growlithe (Hisuian Growlithe),-14,-18,-41,5,-13,-48,-129,21340
78,Arcanine,16,17,-6,40,17,-8,76,8310
79,Arcanine (Hisuian Arcanine),21,22,-6,35,17,-13,76,8420
80,Poliwag,-34,-43,-46,-20,-23,-13,-179,38260
81,Poliwhirl,-9,-28,-21,-10,-13,-13,-94,10580
82,Poliwrath,16,2,9,10,27,-33,31,3220
83,Abra,-49,-73,-71,45,-8,-13,-169,43590
84,Kadabra,-34,-58,-56,60,7,2,-79,17550
85,Alakazam,-19,-43,-41,75,32,17,21,11270
86,Alakazam (Mega Alakazam),-19,-43,-21,115,42,47,121,34490
87,Machop,-4,-13,-36,-25,-28,-68,-174,37790
88,Machoke,6,7,-16,-10,-3,-58,-74,9290
89,Machamp,16,37,-6,5,22,-48,26,5150
90,Bellsprout,-24,-18,-51,10,-33,-63,-179,40700
91,Weepinbell,-9,-3,-36,25,-18,-48,-89,12560
92,Victreebel,6,12,-21,40,7,-33,11,3480
93,Tentacool,-34,-53,-51,-10,37,-33,-144,29860
94,Tentacruel,6,-23,-21,20,57,-3,36,5960
95,Geodude,-34,-13,14,-30,-33,-83,-179,42440
96,Geodude (Alolan Geodude),-34,-13,14,-30,-33,-83,-179,42440
97,Graveler,-19,2,29,-15,-18,-68,-89,14300
98,Graveler (Alolan Graveler),-19,2,29,-15,-18,-68,-89,14300
99,Golem,6,27,44,-5,2,-58,16,6350
100,Golem (Alolan Golem),6,27,44,-5,2,-58,16,6350
101,Ponyta,-24,-8,-31,5,2,-13,-69,6560
102,Ponyta (Galarian Ponyta),-24,-8,-31,5,2,-13,-69,6560
103,Rapidash,-9,7,-16,20,17,2,21,1520
104,Rapidash (Galarian Rapidash),-9,7,-16,20,17,2,21,1520
105,Slowpoke,16,-28,-21,-20,-23,-88,-164,37050
106,Slowpoke (Galarian Slowpoke),16,-28,-21,-20,-23,-88,-164,37050
107,Slowbro,21,-18,24,40,17,-73,11,8680
108,Slowbro (Mega Slowbro),21,-18,94,70,17,-73,111,32440
109,Slowbro (Galarian Slowbro),21,7,9,40,7,-73,11,7670
110,Magnemite,-49,-58,-16,35,-8,-58,-154,34390
111,Magneton,-24,-33,9,60,7,-33,-14,6680
112,Farfetch'd,-22,-3,-31,-2,-1,-43,-102,13712
113,Farfetch'd (Galarian Farfetch'd),-22,2,-31,-2,-1,-48,-102,14162
114,Doduo,-39,-8,-41,-25,-28,-28,-169,34020
115,Dodrio,-14,17,-16,0,-3,7,-9,880
116,Seel,-9,-48,-31,-15,7,-58,-154,30700
117,Dewgong,16,-23,-6,10,32,-33,-4,3050
118,Grimer,6,-13,-36,-20,-13,-78,-154,31870
119,Grimer (Alolan Grimer),6,-13,-36,-20,-13,-78,-154,31870
120,Muk,31,12,-11,5,37,-53,21,5870
121,Muk (Alolan Muk),31,12,-11,5,37,-53,21,5870
122,Shellder,-44,-28,14,-15,-38,-63,-174,38830
123,Cloyster,-24,2,94,25,-18,-33,46,13570
124,Gastly,-44,-58,-56,40,-28,-23,-169,39910
125,Haunter,-29,-43,-41,55,-8,-8,-74,13000
126,Gengar,-14,-28,-26,70,12,7,21,7190
127,Gengar (Mega Gengar),-14,-28,-6,110,32,27,121,29510
128,Onix,-39,-48,74,-30,-18,-33,-94,20450
129,Drowzee,-14,-45,-41,-17,27,-61,-151,31442
130,Hypno,11,-20,-16,13,52,-36,4,4962
131,Krabby,-44,12,4,-35,-38,-53,-154,31290
132,Kingler,-19,37,29,-10,-13,-28,-4,3640
133,Voltorb,-34,-63,-36,-5,-8,-3,-149,28720
134,Voltorb (Hisuian Voltorb),-34,-63,-36,-5,-8,-3,-149,28720
135,Electrode,-14,-43,-16,20,17,47,11,5320
136,Electrode (Hisuian Electrode),-14,-43,-16,20,17,47,11,5320
137,Exeggcute,-14,-53,-6,0,-18,-63,-154,31050
138,Exeggutor,21,2,-1,65,12,-48,51,9720
139,Exeggutor (Alolan Exeggutor),21,12,-1,65,12,-58,51,10920
140,Cubone,-24,-43,9,-20,-13,-68,-159,32980
141,Marowak,-14,-13,24,-10,17,-58,-54,7610
142,Marowak (Alolan Marowak),-14,-13,24,-10,17,-58,-54,7610
143,Hitmonlee,-24,27,-33,-25,47,-16,-24,6060
144,Hitmonchan,-24,12,-7,-25,47,-27,-24,4908
145,Lickitung,16,-38,-11,0,12,-73,-94,16130
146,Koffing,-34,-28,9,0,-18,-68,-139,26290
147,Weezing,-9,-3,34,25,7,-43,11,3890
148,Weezing (Galarian Weezing),-9,-3,34,25,7,-43,11,3890
149,Rhyhorn,6,-8,9,-30,-33,-78,-134,26210
150,Rhydon,31,37,34,-15,-18,-63,6,8040
151,Chansey,176,-88,-81,-25,42,-53,-29,51320
152,Tangela,-9,-38,29,40,-23,-43,-44,8280
153,Kangaskhan,31,2,-6,-20,17,-13,11,1980
154,Kangaskhan (Mega Kangaskhan),31,32,14,0,37,-3,111,15880
155,Horsea,-44,-53,-16,10,-38,-43,-184,42250
156,Seadra,-19,-28,9,35,-18,-18,-39,4620
157,Goldeen,-29,-26,-26,-25,-13,-40,-159,29868
158,Seaking,6,-1,-21,5,17,-35,-29,2858
159,Staryu,-44,-48,-31,10,-8,-18,-139,25010
160,Starmie,-14,-18,-1,40,22,12,41,4430
161,Mr. Mime,-34,-48,-21,40,57,-13,-19,9280
162,Mr. Mime (Galarian Mr. Mime),-24,-28,-21,30,27,-3,-19,3800
163,Scyther,-4,17,-6,-5,17,2,21,1100
164,Jynx,-9,-43,-51,55,32,-8,-24,9220
165,Electabuzz,-9,-10,-29,35,22,2,11,2856
166,Magmar,-9,2,-29,40,22,-10,16,3366
167,Pinsir,-9,32,14,-5,7,-18,21,2140
168,Pinsir (Mega Pinsir),-9,62,34,5,27,2,121,20480
169,Tauros,1,7,9,-20,7,7,11,750
170,Tauros (Paldean Tauros (Combat Breed)),1,17,19,-30,7,-3,11,1730
171,Tauros (Paldean Tauros (Blaze Breed)),1,17,19,-30,7,-3,11,1730
172,Tauros (Paldean Tauros (Aqua Breed)),1,17,19,-30,7,-3,11,1730
173,Magikarp,-54,-83,-31,-45,-43,-23,-279,93010
174,Gyarados,21,32,-7,0,37,-22,61,7088
175,Gyarados (Mega Gyarados),21,62,23,10,67,-22,161,35808
176,Lapras,56,-8,-6,25,32,-43,56,9870
177,Ditto,-26,-45,-38,-12,-15,-55,-191,44020
178,Eevee,-19,-38,-36,-15,2,-48,-154,29350
179,Eevee (Partner Eevee),-9,-18,-16,5,22,-28,-44,3890
180,Vaporeon,56,-28,-26,50,32,-38,46,11680
181,Jolteon,-9,-28,-26,50,32,27,46,7910
182,Flareon,-9,37,-26,35,47,-38,46,9120
183,Porygon,-9,-33,-16,25,12,-63,-84,13220
184,Omanyte,-39,-53,14,30,-8,-68,-124,25490
185,Omastar,-4,-33,39,55,7,-48,16,8260
186,Kabuto,-44,-13,4,-5,-18,-48,-124,20150
187,Kabutops,-14,22,19,5,7,-23,16,1900
188,Aerodactyl,6,12,-21,0,12,27,36,2790
189,Aerodactyl (Mega Aerodactyl),6,42,-1,10,32,47,136,23630
190,Snorlax,86,17,-21,5,47,-73,61,19410
191,Articuno,16,-8,14,35,62,-18,101,16110
192,Articuno (Galarian Articuno),16,-8,-1,65,37,-8,101,16180
193,Zapdos,16,-3,-1,65,27,-3,101,15430
194,Zapdos (Galarian Zapdos),16,32,4,25,27,-3,101,12860
195,Moltres,16,7,4,65,22,-13,101,15400
196,Moltres (Galarian Moltres),16,-8,4,40,62,-13,101,16150
197,Dratini,-33,-29,-41,-10,-13,-53,-179,38730
198,Dragonair,-13,-9,-21,10,7,-33,-59,5410
199,Dragonite,17,41,9,40,37,-23,121,20190
200,Mewtwo,32,17,4,94,27,27,201,52024
201,Mewtwo (Mega Mewtwo X),32,97,14,94,37,27,301,112164
202,Mewtwo (Mega Mewtwo Y),32,57,-16,134,57,37,301,117704
203,Mew,26,7,14,40,37,-3,121,18540
204,Chikorita,-29,-44,-21,-11,2,-58,-161,32628
205,Bayleef,-14,-31,-6,3,17,-43,-74,8816
206,Meganium,6,-11,14,23,37,-23,46,4896
207,Cyndaquil,-35,-41,-43,0,-13,-38,-170,35268
208,Quilava,-16,-29,-28,20,2,-23,-74,8290
209,Typhlosion,4,-9,-8,49,22,-3,55,6080
210,Typhlosion (Hisuian Typhlosion),-1,-9,-8,59,22,-8,55,7200
211,Totodile,-24,-28,-22,-16,-15,-60,-165,33150
212,Croconaw,-9,-13,-6,-1,0,-45,-74,7788
213,Feraligatr,11,12,14,19,20,-25,51,4448
214,Sentret,-39,-47,-52,-25,-18,-83,-264,83968
215,Furret,11,-17,-22,-15,-8,-13,-64,5448
216,Hoothoot,-14,-63,-56,-24,-7,-53,-217,57824
217,Noctowl,26,-43,-36,26,33,-33,-27,7404
218,Ledyba,-34,-73,-56,-20,17,-48,-214,58410
219,Ledian,-19,-58,-36,-5,47,-18,-89,15500
220,Spinarak,-34,-33,-46,-20,-23,-73,-229,63060
221,Ariados,-4,-3,-16,0,7,-63,-79,10540
222,Crobat,11,-3,-6,10,17,27,56,4420
223,Chinchou,1,-55,-48,-4,-7,-36,-149,28892
224,Lanturn,51,-35,-28,16,13,-36,-19,6692
225,Pichu,-54,-53,-71,-25,-28,-43,-274,89100
226,Cleffa,-24,-68,-58,-15,-8,-88,-261,84718
227,Igglybuff,16,-63,-71,-20,-43,-88,-269,91620
228,Togepi,-39,-73,-21,-20,2,-83,-234,69340
229,Togetic,-19,-53,-1,20,42,-63,-74,14780
230,Natu,-34,-43,-41,10,-18,-33,-159,31480
231,Xatu,-9,-18,-16,35,7,-8,-9,2080
232,Mareep,-19,-53,-46,5,-18,-68,-199,49860
233,Flaaffy,-4,-38,-31,20,-3,-58,-114,19190
234,Ampharos,16,-18,-1,55,27,-48,31,7600
235,Ampharos (Mega Ampharos),16,2,19,105,47,-58,131,34380
236,Bellossom,1,-13,9,30,37,-53,11,5450
237,Marill,-4,-73,-36,-40,-13,-63,-229,64820
238,Azumarill,26,-43,-6,0,17,-53,-59,9140
239,Sudowoodo,-4,7,29,-30,2,-73,-69,11900
240,Politoed,16,-18,-11,30,37,-33,21,4500
241,Hoppip,-39,-58,-46,-25,-8,-53,-229,62940
242,Skiploom,-19,-48,-36,-15,2,-23,-139,24040
243,Jumpluff,1,-38,-16,-5,32,7,-19,3160
244,Aipom,-19,-23,-31,-20,-8,-18,-119,16800
245,Sunkern,-44,-63,-56,-30,-33,-73,-299,105760
246,Sunflora,1,-18,-31,45,22,-73,-54,12040
247,Yanma,-9,-28,-41,15,-18,-8,-89,11080
248,Wooper,-19,-48,-41,-35,-38,-88,-269,87120
249,Wooper (Paldean Wooper),-19,-48,-41,-35,-38,-88,-269,87120
250,Quagsire,21,-8,-1,5,2,-68,-49,7560
251,Espeon,-9,-28,-26,70,32,7,46,9630
252,Umbreon,21,-28,24,0,67,-38,46,9850
253,Murkrow,-14,-8,-44,25,-21,-12,-74,8882
254,Slowking,21,-18,-6,40,47,-73,11,10060
255,Slowking (Galarian Slowking),21,-28,-6,50,47,-73,11,11420
256,Misdreavus,-14,-33,-26,25,22,-18,-44,5330
257,Unown,-26,-21,-38,12,-15,-55,-143,26404
258,Wobbuffet,116,-60,-28,-27,-5,-70,-74,28970
259,Girafarig,-4,-13,-21,30,2,-18,-24,2430
260,Pineco,-24,-28,4,-25,-28,-88,-189,46250
261,Forretress,1,-3,54,0,-3,-63,-14,7100
262,Dunsparce,26,-23,-16,5,2,-58,-64,8950
263,Gligar,-9,-18,19,-25,2,-18,-49,4120
264,Steelix,1,-8,114,-5,2,-73,31,19380
265,Steelix (Mega Steelix),1,32,144,-5,32,-73,131,45300
266,Snubbull,-14,-13,-36,-20,-23,-73,-179,39960
267,Granbull,16,27,-11,0,-3,-58,-29,5320
268,Qwilfish,-9,2,-1,-5,-8,-18,-39,2020
269,Qwilfish (Hisuian Qwilfish),-9,2,-1,-5,-8,-18,-39,2020
270,Scizor,-4,37,14,-5,17,-38,21,3780
271,Scizor (Mega Scizor),-4,57,54,5,37,-28,121,23000
272,Shuckle,-54,-83,144,-50,167,-98,26,71210
273,Heracross,6,32,-11,-20,32,-18,21,3370
274,Heracross (Mega Heracross),6,92,29,-20,42,-28,121,26930
275,Sneasel,-19,2,-31,-25,12,12,-49,4640
276,Sneasel (Hisuian Sneasel),-19,2,-31,-25,12,12,-49,4640
277,Teddiursa,-14,-13,-36,-10,-13,-63,-149,28100
278,Ursaring,16,37,-11,15,12,-48,21,4860
279,Slugma,-34,-53,-46,10,-23,-83,-229,66040
280,Magcargo,-14,-43,34,30,17,-73,-49,12120
281,Swinub,-24,-43,-46,-30,-33,-53,-229,61780
282,Piloswine,26,7,-6,0,-3,-53,-29,4420
283,Corsola,-9,-38,9,5,32,-68,-69,12040
284,Corsola (Galarian Corsola),-14,-38,14,5,37,-73,-69,13320
285,Remoraid,-39,-28,-51,5,-28,-38,-179,39200
286,Octillery,1,12,-11,45,12,-58,1,5800
287,Delibird,-29,-38,-41,5,-18,-28,-149,27300
288,Mantine,11,-53,-16,20,77,-33,6,10640
289,Skarmory,-9,-13,54,-20,7,-33,-14,4900
290,Houndour,-29,-33,-56,20,-13,-38,-149,29280
291,Houndoom,1,-3,-36,50,17,-8,21,4600
292,Houndoom (Mega Houndoom),1,-3,4,80,27,12,121,21940
293,Kingdra,1,2,9,35,32,-18,61,6380
294,Phanpy,16,-33,-26,-20,-23,-63,-149,29120
295,Donphan,16,27,34,0,-3,-53,21,5400
296,Porygon2,11,-13,4,45,32,-43,36,6500
297,Stantler,-1,2,-24,25,2,-18,-14,1730
298,Smeargle,-19,-73,-51,-40,-18,-28,-229,63440
299,Tyrogue,-39,-58,-51,-25,-28,-68,-269,85880
300,Hitmontop,-24,2,9,-25,47,-33,-24,5160
301,Smoochum,-29,-63,-71,25,2,-38,-174,42200
302,Elekid,-29,-30,-49,5,-8,-8,-119,18456
303,Magby,-29,-18,-49,10,-8,-20,-114,17126
304,Miltank,21,-13,19,-20,7,-3,11,1550
305,Blissey,181,-83,-76,15,72,-48,61,56860
306,Raikou,16,-8,-11,55,37,12,101,15180
307,Entei,41,22,-1,30,12,-3,101,13420
308,Suicune,26,-18,29,30,52,-18,101,15970
309,Larvitar,-24,-29,-36,-15,-13,-62,-179,38992
310,Pupitar,-4,-9,-16,5,7,-52,-69,7892
311,Tyranitar,26,41,24,35,37,-42,121,21932
312,Tyranitar (Mega Tyranitar),26,71,64,35,57,-32,221,64152
313,Lugia,32,-3,44,30,91,7,201,52600
314,Ho-Oh,32,37,4,50,91,-13,201,53760
315,Celebi,26,7,14,40,37,-3,121,18540
316,Treecko,-34,-48,-51,5,-8,-33,-169,35800
317,Grovyle,-24,-28,-41,25,2,-8,-74,9210
318,Sceptile,-4,-8,-21,45,22,17,51,5920
319,Sceptile (Mega Sceptile),-4,17,-11,85,22,42,151,32700
320,Torchic,-29,-33,-46,10,-13,-58,-169,36240
321,Combusken,-14,-8,-26,25,-3,-48,-74,9350
322,Blaziken,6,27,-16,50,7,-23,51,6700
323,Blaziken (Mega Blaziken),6,67,-6,70,17,-3,151,32560
324,Mudkip,-24,-23,-36,-10,-13,-63,-169,35200
325,Marshtomp,-4,-8,-16,0,7,-53,-74,8670
326,Swampert,26,17,4,25,27,-43,56,7320
327,Swampert (Mega Swampert),26,57,24,35,47,-33,156,33360
328,Poochyena,-39,-38,-51,-30,-33,-68,-259,79260
329,Mightyena,-4,-3,-16,0,-3,-33,-59,4860
330,Zigzagoon,-36,-63,-45,-30,-22,-43,-239,67644
331,Zigzagoon (Galarian Zigzagoon),-36,-63,-45,-30,-22,-43,-239,67644
332,Linoone,4,-23,-25,-10,-2,-3,-59,4764
333,Linoone (Galarian Linoone),4,-23,-25,-10,-2,-3,-59,4764
334,Wurmple,-29,-48,-51,-40,-33,-83,-284,95980
335,Silcoon,-24,-58,-31,-35,-38,-88,-274,90390
336,Beautifly,-14,-23,-36,40,-13,-38,-84,12290
337,Cascoon,-24,-58,-31,-35,-38,-88,-274,90390
338,Dustox,-14,-43,-16,-10,27,-38,-94,13410
339,Lotad,-34,-63,-56,-20,-13,-73,-259,81240
340,Lombre,-14,-43,-36,0,7,-53,-139,25520
341,Ludicolo,6,-23,-16,30,37,-33,1,4180
342,Seedot,-34,-53,-36,-30,-33,-73,-259,79660
343,Nuzleaf,-4,-23,-46,0,-23,-43,-139,24360
344,Shiftry,16,7,-26,30,-3,-23,1,2420
345,Taillow,-34,-38,-56,-30,-33,-18,-209,51730
346,Swellow,-14,-8,-26,15,-13,22,-24,2390
347,Wingull,-34,-63,-56,-5,-33,-18,-209,53380
348,Pelipper,-14,-43,14,35,7,-38,-39,6480
349,Ralts,-46,-68,-61,-15,-28,-63,-281,94400
350,Kirlia,-36,-58,-51,5,-8,-53,-201,50560
351,Gardevoir,-6,-28,-21,65,52,-23,39,10240
352,Gardevoir (Mega Gardevoir),-6,-8,-21,105,72,-3,139,36080
353,Surskit,-34,-63,-54,-10,-11,-38,-210,53806
354,Masquerain,-4,-33,-24,40,19,-23,-25,4796
355,Shroomish,-14,-53,-26,-20,-3,-68,-184,42570
356,Breloom,-14,37,-6,0,-3,-33,-19,3060
357,Slakoth,-14,-33,-26,-25,-28,-73,-199,48300
358,Vigoroth,6,-13,-6,-5,-8,-13,-39,2020
359,Slaking,76,67,14,35,2,-3,191,48180
360,Nincada,-43,-48,4,-30,-33,-63,-213,55496
361,Ninjask,-13,-3,-41,-10,-13,57,-23,5906
362,Shedinja,-73,-3,-41,-30,-33,-63,-243,72026
363,Whismur,-10,-42,-63,-9,-40,-75,-239,70260
364,Loudred,10,-22,-43,11,-20,-55,-119,20140
365,Exploud,30,-2,-23,31,10,-35,11,3840
366,Makuhita,-2,-33,-56,-40,-33,-78,-242,71566
367,Hariyama,70,27,-26,-20,-3,-53,-5,9548
368,Azurill,-24,-73,-46,-40,-23,-83,-289,100560
369,Nosepass,-44,-48,49,-15,27,-73,-104,23740
370,Skitty,-24,-48,-41,-25,-28,-53,-219,56740
371,Delcatty,-4,-28,-21,-5,-8,-13,-79,7740
372,Sableye,-24,-18,-11,5,2,-53,-99,13660
373,Sableye (Mega Sableye),-24,-8,39,25,52,-83,1,12380
374,Mawile,-24,-8,-1,-5,-8,-53,-99,13340
375,Mawile (Mega Mawile),-24,12,39,-5,32,-53,1,6100
376,Aron,-24,-23,14,-20,-23,-73,-149,29760
377,Lairon,-14,-3,54,-10,-13,-63,-49,9760
378,Aggron,-4,17,94,0,-3,-53,51,14560
379,Aggron (Mega Aggron),-4,47,144,0,17,-53,151,48860
380,Meditite,-44,-53,-31,-20,-8,-43,-199,47620
381,Medicham,-14,-33,-11,0,12,-23,-69,6840
382,Medicham (Mega Medicham),-14,7,-1,20,22,-3,31,2100
383,Electrike,-34,-48,-46,5,-23,-38,-184,41430
384,Manectric,-4,-18,-26,45,-3,2,-4,3070
385,Manectric (Mega Manectric),-4,-18,-6,75,17,32,96,16530
386,Plusle,-14,-43,-46,25,12,-8,-74,10470
387,Minun,-14,-53,-36,15,22,-8,-74,10550
388,Volbeat,-9,-20,-11,-13,22,-18,-49,3980
389,Illumise,-9,-46,-11,13,22,-18,-49,5696
390,Roselia,-24,-33,-41,40,17,-38,-79,12920
391,Gulpin,-4,-50,-33,-17,-10,-63,-177,39292
392,Swalot,26,-20,-3,13,20,-48,-12,4102
393,Carvanha,-29,-3,-66,5,-43,-38,-174,38800
394,Sharpedo,-4,27,-46,35,-23,-8,-19,5040
395,Sharpedo (Mega Sharpedo),-4,47,-16,50,2,2,81,11550
396,Wailmer,56,-23,-51,10,-28,-43,-79,15240
397,Wailord,96,-3,-41,30,-18,-43,21,14420
398,Numel,-14,-33,-46,5,-18,-68,-174,38650
399,Camerupt,-4,7,-16,45,12,-63,-19,6820
400,Camerupt (Mega Camerupt),-4,27,14,85,42,-83,81,23380
401,Torkoal,-4,-8,54,25,7,-83,-9,10640
402,Spoink,-14,-68,-51,10,17,-43,-149,31860
403,Grumpig,6,-48,-21,30,47,-23,-9,6500
404,Spinda,-14,-33,-26,0,-3,-43,-119,17980
405,Trapinch,-29,7,-41,-15,-18,-93,-189,47490
406,Vibrava,-24,-23,-36,-10,-13,-33,-139,23080
407,Flygon,6,7,-6,20,17,-3,41,2500
408,Cacnea,-24,-8,-46,25,-23,-68,-144,29270
409,Cacturne,-4,22,-26,55,-3,-48,-4,6530
410,Swablu,-29,-53,-26,-20,12,-53,-169,36240
411,Altaria,1,-23,4,10,42,-23,11,3060
412,Altaria (Mega Altaria),1,17,24,50,42,-23,111,17980
413,Zangoose,-1,22,-26,0,-3,-13,-21,1780
414,Seviper,-1,7,-26,40,-3,-38,-21,4220
415,Lunatone,16,-38,-21,35,22,-33,-19,5300
416,Solrock,16,2,-1,-5,2,-33,-19,1740
417,Barboach,-24,-45,-43,-14,-22,-43,-191,43460
418,Whiscash,36,-15,-13,16,8,-43,-11,3980
419,Corphish,-31,-13,-21,-10,-28,-68,-171,36320
420,Crawdaunt,-11,27,-1,30,-8,-48,-11,4240
421,Baltoy,-34,-53,-31,-20,7,-48,-179,39720
422,Claydol,-14,-23,19,10,57,-28,21,5660
423,Lileep,-8,-52,-9,1,24,-80,-124,25202
424,Cradily,12,-12,11,21,44,-60,16,6642
425,Anorith,-29,2,-36,-20,-13,-28,-124,18870
426,Armaldo,1,32,14,10,17,-58,16,5230
427,Feebas,-54,-78,-66,-50,-8,-23,-279,94290
428,Milotic,21,-33,-7,40,62,-22,61,11228
429,Castform,-4,-23,-16,10,7,-33,-59,5520
430,Kecleon,-14,-3,-16,0,57,-63,-39,9200
431,Shuppet,-30,-18,-51,3,-30,-58,-184,41954
432,Banette,-10,22,-21,23,0,-38,-24,3574
433,Banette (Mega Banette),-10,72,-11,33,20,-28,76,13454
434,Duskull,-54,-53,4,-30,27,-78,-184,47310
435,Dusclops,-34,-23,44,0,67,-78,-24,14770
436,Tropius,25,-25,-3,12,24,-52,-19,5044
437,Chimecho,1,-43,-6,35,27,-38,-24,5860
438,Absol,-9,37,-26,15,-3,-28,-14,3340
439,Absol (Mega Absol),-9,57,-26,55,-3,12,86,14580
440,Wynaut,21,-70,-38,-37,-15,-80,-219,62740
441,Snorunt,-24,-43,-36,-10,-13,-53,-179,38840
442,Glalie,6,-13,-6,20,17,-23,1,1460
443,Glalie (Mega Glalie),6,27,-6,60,17,-3,101,14900
444,Spheal,-4,-53,-36,-5,-13,-78,-189,46120
445,Sealeo,16,-33,-16,15,7,-58,-69,10000
446,Walrein,36,-13,4,35,27,-38,51,7480
447,Clamperl,-39,-29,-1,14,-8,-71,-134,25620
448,Huntail,-19,11,19,34,12,-51,6,4780
449,Gorebyss,-19,-9,19,54,12,-51,6,6500
450,Relicanth,26,-3,44,-15,2,-48,6,5190
451,Luvdisc,-31,-63,-31,-20,2,-6,-149,28532
452,Bagon,-29,-18,-26,-20,-33,-53,-179,38180
453,Shelgon,-9,2,14,0,-13,-53,-59,6740
454,Salamence,21,42,-6,50,17,-3,121,19680
455,Salamence (Mega Salamence),21,52,44,60,27,17,221,58540
456,Beldum,-34,-38,-6,-25,-3,-73,-179,40640
457,Metang,-14,-18,14,-5,17,-53,-59,7320
458,Metagross,6,42,44,35,27,-33,121,21420
459,Metagross (Mega Metagross),6,52,64,45,47,7,221,59960
460,Regirock,6,7,114,-10,37,-53,101,27560
461,Regice,6,-43,14,40,137,-53,101,35460
462,Registeel,6,-18,64,15,87,-53,101,25260
463,Latias,6,-13,4,50,67,7,121,21900
464,Latias (Mega Latias),6,7,34,80,87,7,221,64100
465,Latios,6,-3,-6,70,47,7,121,21880
466,Latios (Mega Latios),6,37,14,100,57,7,221,63740
467,Kyogre,26,7,4,90,77,-13,191,51420
468,Kyogre (Primal Kyogre),26,57,4,120,97,-13,291,112600
469,Groudon,26,57,54,40,27,-13,191,45820
470,Groudon (Primal Groudon),26,87,74,90,27,-13,291,107400
471,Rayquaza,31,57,4,90,27,-8,201,53520
472,Rayquaza (Mega Rayquaza),31,87,14,120,37,12,301,115240
473,Jirachi,26,7,14,40,37,-3,121,18540
474,Deoxys (Normal Forme),-24,57,-36,90,-13,47,121,30240
475,Deoxys (Attack Forme),-24,87,-66,120,-43,47,121,45600
476,Deoxys (Defense Forme),-24,-23,74,10,97,-13,121,30900
477,Deoxys (Speed Forme),-24,2,4,35,27,77,121,23120
478,Turtwig,-19,-25,-22,-15,-8,-72,-161,32864
479,Grotle,1,-4,-1,-5,2,-67,-74,10012
480,Torterra,21,16,19,15,22,-47,46,6092
481,Chimchar,-30,-35,-42,-2,-19,-42,-170,34918
482,Monferno,-10,-15,-34,18,-11,-22,-74,7886
483,Infernape,2,11,-15,44,8,5,55,5400
484,Piplup,-21,-42,-33,1,-7,-63,-165,34538
485,Prinplup,-10,-27,-18,21,13,-53,-74,10048
486,Empoleon,10,-7,2,51,38,-43,51,8648
487,Starly,-34,-38,-56,-30,-33,-43,-234,64330
488,Staravia,-19,-18,-36,-20,-23,-23,-139,22760
489,Staraptor,11,27,-16,-10,-3,-3,6,1260
490,Bidoof,-15,-48,-46,-25,-23,-72,-229,63424
491,Bibarel,5,-8,-26,-5,-3,-32,-69,6584
492,Kricketot,-37,-68,-45,-35,-22,-78,-285,97036
493,Kricketune,3,-8,-35,-5,-12,-38,-95,11936
494,Shinx,-29,-28,-52,-20,-29,-58,-216,55590
495,Luxio,-14,-8,-37,0,-14,-43,-116,17130
496,Luxray,6,27,-7,35,16,-33,44,5320
497,Budew,-34,-63,-51,-10,7,-48,-199,49780
498,Roserade,-14,-23,-21,65,42,-13,36,8620
499,Cranidos,-7,32,-46,-30,-33,-45,-129,23844
500,Rampardos,23,72,-26,5,-13,-45,16,8864
501,Shieldon,-44,-51,32,-18,25,-73,-129,28480
502,Bastiodon,-14,-41,82,-13,75,-73,16,19980
503,Burmy,-34,-64,-41,-31,-18,-67,-255,77732
504,Wormadam (Plant Cloak),-14,-34,-1,19,42,-67,-55,10992
505,Wormadam (Sandy Cloak),-14,-14,19,-1,22,-67,-55,8752
506,Wormadam (Trash Cloak),-14,-24,9,9,32,-67,-55,9472
507,Mothim,-4,1,-36,34,-13,-37,-55,7032
508,Combee,-44,-63,-44,-30,-21,-33,-235,65496
509,Vespiquen,-4,-13,16,20,39,-63,-5,6356
510,Pachirisu,-14,-48,-16,-15,27,-8,-74,9250
511,Buizel,-19,-28,-51,0,-33,-18,-149,27360
512,Floatzel,11,12,-31,25,-13,12,16,2420
513,Cherubi,-29,-58,-41,2,-10,-68,-204,52230
514,Cherrim,-4,-33,-16,27,15,-18,-29,3480
515,Shellos,2,-45,-38,-3,-1,-69,-154,31960
516,Gastrodon,37,-10,-18,32,19,-64,-4,7290
517,Ambipom,1,7,-20,0,3,12,3,612
518,Drifloon,16,-43,-52,0,-19,-33,-131,23420
519,Drifblim,76,-13,-42,30,-9,-23,19,9580
520,Buneary,-19,-27,-42,-16,-7,-18,-129,20124
521,Lopunny,-9,-17,-2,-6,33,2,1,1504
522,Lopunny (Mega Lopunny),-9,43,8,-6,33,32,101,14344
523,Mismagius,-14,-33,-26,45,42,2,16,6010
524,Honchkrow,26,32,-34,45,-11,-32,26,6702
525,Glameow,-25,-38,-44,-18,-26,-18,-169,33890
526,Purugly,-3,-11,-22,4,-4,9,-27,1456
527,Chingling,-29,-63,-36,5,-13,-58,-194,47300
528,Stunky,-11,-30,-39,-19,-22,-29,-150,26728
529,Skuntank,29,0,-19,11,-2,-19,0,1688
530,Bronzor,-17,-69,0,-36,23,-80,-179,45316
531,Bronzong,-7,-4,30,19,53,-70,21,9476
532,Bonsly,-24,-13,9,-50,-18,-93,-189,48020
533,Mime Jr.,-54,-68,-41,10,27,-43,-169,40460
534,Happiny,26,-88,-81,-45,2,-73,-259,89420
535,Chatot,2,-28,-41,32,-21,-12,-68,8702
536,Spiritomb,-24,-1,22,32,45,-68,6,8770
537,Gible,-16,-23,-41,-20,-18,-61,-179,38952
538,Gabite,-6,-3,-21,-10,-8,-21,-69,5852
539,Garchomp,34,37,9,20,22,-1,121,18132
540,Garchomp (Mega Garchomp),34,77,29,60,32,-11,221,61512
541,Munchlax,61,-8,-46,-20,22,-98,-89,24310
542,Riolu,-34,-23,-46,-25,-23,-43,-194,44440
543,Lucario,-4,17,-16,55,7,-13,46,5920
544,Lucario (Mega Lucario),-4,52,2,80,7,9,146,30570
545,Hippopotas,-6,-21,-8,-22,-21,-71,-149,28708
546,Hippowdon,34,19,32,8,9,-56,46,7938
547,Skorupi,-34,-43,4,-30,-8,-38,-149,27630
548,Drapion,-4,-3,24,0,12,-8,21,1250
549,Croagunk,-26,-32,-46,1,-23,-53,-179,39196
550,Toxicroak,9,13,-21,26,2,-18,11,1816
551,Carnivine,0,7,-14,30,9,-57,-25,5100
552,Finneon,-25,-44,-30,-11,-2,-37,-149,27156
553,Lumineon,-5,-24,-10,9,23,-12,-19,1816
554,Mantyke,-29,-73,-36,0,57,-53,-134,31480
555,Snover,-14,-31,-36,2,-3,-63,-145,27460
556,Abomasnow,16,-1,-11,32,22,-43,15,3960
557,Abomasnow (Mega Abomasnow),16,39,19,72,42,-73,115,27640
558,Weavile,-4,27,-21,-15,22,22,31,3340
559,Magnezone,-4,-23,29,70,27,-43,56,12000
560,Lickilicky,36,-8,9,20,32,-53,36,6970
561,Rhyperior,41,47,44,-5,-8,-63,56,13020
562,Tangrowth,26,7,39,50,-13,-53,56,10860
563,Electivire,1,30,-19,35,22,-8,61,6756
564,Magmortar,1,2,-19,65,32,-20,61,9736
565,Togekiss,11,-43,9,60,52,-23,66,13240
566,Yanmega,12,-17,0,56,-7,-8,36,4978
567,Leafeon,-9,17,44,0,2,-8,46,4490
568,Glaceon,-9,-33,24,70,32,-38,46,11230
569,Gliscor,1,2,39,-15,12,-8,31,2920
570,Mamoswine,36,37,-6,10,-3,-23,51,5940
571,Porygon-Z,11,-13,-16,75,12,-13,56,9620
572,Gallade,-6,32,-21,5,52,-23,39,6280
573,Gallade (Mega Gallade),-6,72,9,5,52,7,139,27400
574,Probopass,-14,-38,59,15,87,-63,46,19000
575,Dusknoir,-29,7,49,5,72,-58,46,13980
576,Froslass,-4,-13,-16,20,7,7,1,940
577,Rotom,-24,-43,-9,35,14,-12,-39,5592
578,Rotom (Heat Rotom),-24,-28,21,45,44,-17,41,7732
579,Rotom (Wash Rotom),-24,-28,21,45,44,-17,41,7732
580,Rotom (Frost Rotom),-24,-28,21,45,44,-17,41,7732
581,Rotom (Fan Rotom),-24,-28,21,45,44,-17,41,7732
582,Rotom (Mow Rotom),-24,-28,21,45,44,-17,41,7732
583,Uxie,1,-18,44,15,67,-8,101,17240
584,Mesprit,6,12,19,45,42,-23,101,15060
585,Azelf,1,32,-16,65,7,12,101,15900
586,Dialga,26,27,34,90,37,-13,201,52600
587,Dialga (Origin Forme),26,7,34,90,57,-13,201,53800
588,Palkia,16,27,14,90,57,-3,201,52940
589,Palkia (Origin Forme),16,7,14,90,57,17,201,52540
590,Heatran,17,-3,20,70,43,-26,121,22764
591,Regigigas,36,67,24,20,47,-3,191,45460
592,Giratina (Altered Forme),76,7,34,40,57,-13,201,52400
593,Giratina (Origin Forme),76,27,14,60,37,-13,201,52240
594,Cresselia,46,-23,34,15,67,-18,121,23480
595,Phione,6,-13,-6,20,17,-23,1,1460
596,Manaphy,26,7,14,40,37,-3,121,18540
597,Darkrai,-4,-3,4,75,27,22,121,21520
598,Shaymin (Land Forme),26,7,14,40,37,-3,121,18540
599,Shaymin (Sky Forme),26,10,-11,60,12,24,121,19858
600,Arceus,46,27,34,60,57,17,241,69220
601,Victini,26,7,14,40,37,-3,121,18540
602,Snivy,-29,-48,-31,-15,-8,-40,-171,35236
603,Servine,-14,-33,-11,0,12,-20,-66,6306
604,Serperior,1,-18,9,15,32,10,49,4156
605,Tepig,-9,-30,-41,-15,-18,-58,-171,35816
606,Pignite,16,0,-31,10,-8,-48,-61,7406
607,Emboar,36,30,-21,40,2,-38,49,8086
608,Oshawott,-19,-38,-41,3,-18,-58,-171,36424
609,Dewott,1,-18,-26,23,-3,-43,-66,7744
610,Samurott,21,7,-1,48,7,-33,49,6334
611,Samurott (Hisuian Samurott),16,15,-6,40,2,-18,49,4846
612,Patrat,-29,-38,-47,-25,-24,-61,-224,59592
613,Watchog,-14,-8,-17,0,6,-26,-59,4742
614,Lillipup,-29,-33,-41,-35,-18,-48,-204,49080
615,Herdier,-9,-13,-21,-25,2,-43,-109,15050
616,Stoutland,11,17,4,-15,27,-23,21,2350
617,Purrloin,-33,-43,-49,-10,-26,-37,-198,46688
618,Liepard,-10,-5,-36,28,-13,3,-33,3472
619,Pansage,-24,-40,-38,-7,-15,-39,-163,31984
620,Simisage,1,5,-23,38,0,-2,19,2364
621,Pansear,-24,-40,-38,-7,-15,-39,-163,31984
622,Simisear,1,5,-23,38,0,-2,19,2364
623,Panpour,-24,-40,-38,-7,-15,-39,-163,31984
624,Simipour,1,5,-23,38,0,-2,19,2364
625,Munna,2,-68,-41,7,-8,-79,-187,47632
626,Musharna,42,-38,-1,47,32,-74,8,11982
627,Pidove,-24,-38,-36,-24,-33,-60,-215,54806
628,Tranquill,-12,-16,-24,-10,-21,-38,-121,17602
629,Unfezant,6,22,-6,5,-8,-10,9,826
630,Blitzle,-29,-33,-54,-10,-31,-27,-184,40492
631,Zebstrika,1,7,-23,20,0,13,18,1472
632,Roggenrola,-19,-18,-1,-35,-38,-88,-199,50700
633,Boldore,-4,12,19,-10,-23,-83,-89,15960
634,Gigalith,11,42,44,0,17,-78,36,11490
635,Woobat,-9,-48,-43,-5,-20,-31,-156,29956
636,Swoobat,-7,-36,-31,17,-8,11,-54,5696
637,Drilbur,-14,-8,-46,-30,-18,-35,-151,27626
638,Excadrill,36,42,-26,-10,2,-15,29,4906
639,Audino,29,-33,0,0,23,-53,-34,6424
640,Audino (Mega Audino),29,-33,40,20,63,-53,66,15064
641,Timburr,1,-13,-31,-35,-28,-68,-174,38040
642,Gurdurr,11,12,-1,-20,-13,-63,-74,10280
643,Conkeldurr,31,47,9,-5,2,-58,26,7320
644,Tympole,-24,-43,-46,-10,-23,-39,-185,40916
645,Palpitoad,1,-28,-31,5,-8,-34,-95,12016
646,Seismitoad,31,2,-11,25,12,-29,30,3596
647,Throh,46,7,-1,-30,22,-58,-14,7110
648,Sawk,1,32,-11,-30,12,-18,-14,2710
649,Sewaddle,-29,-40,-16,-20,-3,-61,-169,35388
650,Swadloon,-19,-30,4,-10,17,-61,-99,15188
651,Leavanny,1,10,-6,10,17,-11,21,1088
652,Venipede,-44,-48,-27,-30,-24,-46,-219,56522
653,Whirlipede,-34,-38,13,-20,16,-56,-119,20722
654,Scolipede,-14,7,3,-5,6,9,6,432
655,Cottonee,-34,-66,-26,-23,-13,-37,-199,47856
656,Whimsicott,-14,-26,-1,17,12,13,1,1476
657,Petilil,-29,-58,-36,10,-13,-73,-199,50700
658,Lilligant,-4,-33,-11,50,12,-13,1,4040
659,Lilligant (Hisuian Lilligant),-4,12,-11,-10,12,2,1,530
660,Basculin,-4,-1,-21,20,-8,-5,-19,1308
661,Sandile,-24,-21,-51,-25,-28,-38,-187,41440
662,Krokorok,-14,-11,-41,-15,-18,-29,-128,19772
663,Krookodile,21,24,-6,5,7,-11,40,2848
664,Darumaka,-4,-3,-41,-45,-18,-53,-164,33760
665,Darumaka (Galarian Darumaka),-4,-3,-41,-45,-18,-53,-164,33760
666,Darmanitan (Standard Mode),31,47,-31,-30,-8,-8,1,5160
667,Darmanitan (Zen Mode),31,-63,19,80,42,-48,61,19480
668,Darmanitan (Galarian Standard Mode),31,47,-31,-30,-8,-8,1,5160
669,Darmanitan (Galarian Zen Mode),31,67,-31,-30,-8,32,61,12120
670,Maractus,1,-7,-19,46,4,-43,-18,4716
671,Dwebble,-24,-28,-1,-25,-28,-48,-154,28790
672,Crustle,-4,12,39,5,12,-58,6,5250
673,Scraggy,-24,-18,-16,-25,7,-55,-131,22016
674,Scrafty,-9,-3,29,-15,52,-45,9,5966
675,Sigilyph,-2,-35,-6,43,17,-6,11,3560
676,Yamask,-36,-63,-1,-5,2,-73,-176,41600
677,Yamask (Galarian Yamask),-36,-38,-1,-30,2,-73,-176,39950
678,Cofagrigus,-16,-43,59,35,42,-73,4,13920
679,Tirtouga,-20,-15,17,-7,-18,-81,-124,23224
680,Carracosta,0,15,47,23,2,-71,16,8264
681,Archen,-19,19,-41,14,-18,-33,-78,10096
682,Archeops,1,47,-21,52,2,7,88,13152
683,Trubbish,-24,-43,-24,-20,-1,-38,-150,27346
684,Garbodor,6,2,-4,0,19,-28,-5,1226
685,Zorua,-34,-28,-46,20,-23,-38,-149,28630
686,Zorua (Hisuian Zorua),-39,-33,-46,25,-23,-33,-149,29170
687,Zoroark,-14,12,-26,60,-3,2,31,5590
688,Zoroark (Hisuian Zoroark),-19,7,-26,65,-3,7,31,6330
689,Minccino,-19,-43,-46,-20,-23,-28,-179,38080
690,Cinccino,1,2,-26,5,-3,12,-9,940
691,Gothita,-29,-63,-36,-5,2,-58,-189,45220
692,Gothorita,-14,-48,-16,15,22,-48,-89,13690
693,Gothitelle,-4,-38,9,35,47,-38,11,6540
694,Solosis,-29,-63,-46,45,-13,-83,-189,51730
695,Duosion,-9,-53,-36,65,-3,-73,-109,25630
696,Reuniclus,36,-28,-11,65,22,-73,11,12360
697,Ducklett,-12,-49,-36,-16,-13,-48,-174,36846
698,Swanna,1,-6,-23,27,0,-5,-6,1356
699,Vanillite,-38,-43,-36,5,-3,-59,-174,38380
700,Vanillish,-23,-28,-21,20,12,-44,-84,11290
701,Vanilluxe,-3,2,-1,50,32,-24,56,7250
702,Deerling,-14,-33,-36,-20,-13,-28,-144,24670
703,Sawsbuck,6,7,-16,0,7,-8,-4,470
704,Emolga,-19,-18,-26,15,-3,0,-51,4196
705,Karrablast,-24,-18,-41,-20,-18,-43,-164,32050
706,Escavalier,-4,42,19,0,42,-83,16,11050
707,Foongus,-5,-38,-41,-5,-8,-88,-185,45208
708,Amoonguss,40,-8,-16,25,17,-73,-15,8388
709,Frillish,-19,-53,-36,5,22,-63,-144,29680
710,Jellicent,26,-33,-16,25,42,-43,1,6260
711,Alomomola,91,-18,-6,-20,-18,-38,-9,10890
712,Joltik,-24,-46,-36,-3,-13,-38,-160,31210
713,Galvantula,-4,-16,-26,37,-3,5,-7,2400
714,Ferroseed,-30,-43,5,-36,23,-93,-174,43524
715,Ferrothorn,0,1,45,-6,53,-83,10,11860
716,Klink,-34,-38,-16,-15,-3,-73,-179,40460
717,Klang,-14,-13,9,10,22,-53,-39,5360
718,Klinklang,-14,7,29,10,22,-13,41,3520
719,Tynamo,-39,-38,-46,-15,-23,-43,-204,49300
720,Eelektrik,-9,-8,-16,15,7,-63,-74,10120
721,Eelektross,11,22,-6,45,17,-53,36,7060
722,Elgyem,-19,-38,-31,25,-8,-73,-144,29520
723,Beheeyem,1,-18,-11,65,32,-63,6,9700
724,Litwick,-24,-63,-31,5,-8,-83,-204,54100
725,Lampent,-14,-53,-26,35,-3,-48,-109,19100
726,Chandelure,-14,-38,4,85,27,-23,41,11820
727,Axew,-28,-6,-26,-30,-23,-46,-159,30322
728,Fraxure,-8,24,-16,-20,-13,-36,-69,7522
729,Haxorus,2,54,4,0,7,-6,61,6742
730,Cubchoo,-19,-23,-46,0,-23,-63,-174,37780
731,Beartic,21,37,-6,10,17,-53,26,5720
732,Cryogonal,6,-43,-36,35,72,2,36,10890
733,Shelmet,-24,-53,-1,-20,2,-78,-174,40150
734,Accelgor,6,-23,-46,40,-3,42,16,6310
735,Stunfisk,35,-27,-2,21,36,-71,-8,8800
736,Stunfisk (Galarian Stunfisk),35,-12,13,6,21,-71,-8,7120
737,Mienfoo,-29,-8,-36,-5,-13,-38,-129,20480
738,Mienshao,-9,32,-26,35,-3,2,31,3980
739,Druddigon,3,27,4,0,27,-55,6,4544
740,Golett,-15,-19,-36,-25,-13,-68,-176,38276
741,Golurk,15,31,-6,-5,17,-48,4,3856
742,Pawniard,-29,-8,-16,-20,-23,-43,-139,23260
743,Bisharp,-9,32,14,0,7,-33,11,2560
744,Bouffalant,21,17,9,-20,32,-48,11,4660
745,Rufflet,-4,-10,-36,-23,-13,-43,-129,20600
746,Braviary,26,30,-11,-3,12,-23,31,3340
747,Braviary (Hisuian Braviary),36,-10,-16,52,7,-38,31,6810
748,Vullaby,-4,-38,-11,-15,2,-43,-109,15540
749,Mandibuzz,36,-28,19,-5,32,-23,31,4980
750,Heatmor,11,4,-20,45,3,-38,5,4040
751,Durant,-16,16,26,-12,-15,6,5,1618
752,Deino,-22,-28,-36,-15,-13,-65,-179,39224
753,Zweilous,-2,-8,-16,5,7,-45,-59,5904
754,Hydreigon,18,12,4,65,27,-5,121,20104
755,Larvesta,-19,-8,-31,-10,-8,-43,-119,17560
756,Volcarona,11,-33,-21,75,42,-3,71,14090
757,Cobalion,17,-3,43,30,9,5,101,13354
758,Terrakion,17,36,4,12,27,5,101,12700
759,Virizion,17,-3,-14,30,66,5,101,15976
760,Tornadus (Incarnate Forme),5,22,-16,65,17,8,101,15544
761,Tornadus (Therian Forme),5,7,-6,50,27,18,101,13864
762,Thundurus (Incarnate Forme),5,22,-16,65,17,8,101,15544
763,Thundurus (Therian Forme),5,12,-16,85,17,-2,101,18144
764,Reshiram,26,27,14,90,57,-13,201,53520
765,Zekrom,26,57,34,60,37,-13,201,50620
766,Landorus (Incarnate Forme),15,32,4,55,17,-2,121,19224
767,Landorus (Therian Forme),15,52,4,45,17,-12,121,20044
768,Kyurem,51,37,4,70,27,-8,181,42440
769,Kyurem (Black Kyurem),51,77,14,60,27,-8,221,61960
770,Kyurem (White Kyurem),51,27,4,110,37,-8,221,65720
771,Keldeo,17,-21,4,69,27,5,101,16462
772,Meloetta (Aria Forme),26,-16,-9,68,65,-13,121,24672
773,Meloetta (Pirouette Forme),26,35,4,17,14,25,121,17668
774,Genesect,-3,27,9,60,32,-4,121,20100
775,Chespin,-18,-32,-21,-12,-18,-65,-166,34038
776,Quilladin,-13,-15,9,-4,-5,-46,-74,8108
777,Chesnaught,14,14,36,14,12,-39,51,6150
778,Fennekin,-34,-48,-46,2,-3,-43,-172,37022
779,Braixen,-15,-34,-28,30,7,-30,-70,8914
780,Delphox,1,-24,-14,54,37,1,55,8084
781,Froakie,-33,-37,-46,2,-19,-32,-165,33188
782,Frogadier,-20,-30,-34,23,-7,-6,-74,8546
783,Greninja,-2,2,-19,43,8,19,51,5244
784,Greninja (Ash-Greninja),-2,52,-19,93,8,29,161,38544
785,Bunnelby,-36,-57,-48,-28,-27,-46,-242,69042
786,Diggersby,11,-37,-9,-10,14,-25,-56,5628
787,Fletchling,-29,-43,-43,-20,-25,-41,-201,47646
788,Fletchinder,-12,-20,-31,-4,-11,-19,-97,11412
789,Talonflame,4,-12,-15,14,6,23,20,1546
790,Scatterbug,-36,-58,-46,-33,-38,-68,-279,91774
791,Spewpa,-29,-71,-26,-33,-33,-74,-266,84968
792,Vivillon,6,-41,-36,30,-13,-14,-68,8902
793,Litleo,-12,-43,-28,13,-9,-31,-110,16088
794,Pyroar,12,-25,-14,49,3,3,28,4168
795,Flabébé,-30,-55,-47,1,16,-61,-176,41088
796,Floette,-20,-48,-39,15,35,-51,-108,19940
797,Florges,4,-28,-18,52,91,-28,73,18222
798,Skiddo,-8,-28,-38,2,-6,-51,-129,21574
799,Gogoat,49,7,-24,37,18,-35,52,8648
800,Pancham,-7,-11,-24,-14,-15,-60,-131,21928
801,Pangoro,21,31,-8,9,8,-45,16,3892
802,Furfrou,1,-13,-26,5,27,-1,-7,1650
803,Espurr,-12,-45,-32,3,-3,-35,-124,19812
804,Meowstic,0,-45,-10,23,18,1,-13,3148
805,Honedge,-29,-13,14,-25,-26,-75,-154,31848
806,Doublade,-15,17,64,-15,-14,-68,-31,10616
807,Aegislash (Shield Forme),-14,-43,54,-10,77,-43,21,13280
808,Aegislash (Blade Forme),-14,47,-36,80,-13,-43,21,12560
809,Spritzee,4,-41,-26,3,2,-80,-138,27830
810,Aromatisse,27,-21,-14,39,26,-74,-17,9328
811,Swirlix,-12,-45,-20,-1,-6,-54,-138,24566
812,Slurpuff,8,-13,0,25,12,-31,1,1964
813,Inkay,-21,-39,-33,-23,-17,-58,-191,43714
814,Malamar,12,-1,2,8,12,-30,3,1266
815,Binacle,-32,-41,-19,-21,-7,-53,-173,36294
816,Barbaracle,-2,12,29,-6,23,-35,21,3220
817,Skrelp,-24,-33,-26,0,-3,-73,-159,32960
818,Dragalge,-9,-18,4,37,60,-59,15,9096
819,Clauncher,-24,-40,-24,-2,0,-59,-149,28438
820,Clawitzer,-3,-20,2,60,26,-44,21,7066
821,Helioptile,-30,-55,-53,1,-20,-33,-190,44324
822,Heliolisk,-12,-38,-34,49,31,6,2,6146
823,Tyrunt,-16,-4,-9,-15,-18,-55,-117,17616
824,Tyrantrum,8,28,33,9,-4,-32,42,4822
825,Amaura,3,-34,-36,7,0,-57,-117,19448
826,Aurorus,49,-16,-14,39,29,-45,42,9004
827,Sylveon,21,-28,-21,50,67,-43,46,12620
828,Hawlucha,4,-1,-11,14,0,15,21,1000
829,Dedenne,-7,-35,-29,21,4,-2,-48,4880
830,Carbink,-24,-43,64,-10,87,-53,21,17440
831,Goomy,-29,-43,-51,-5,12,-63,-179,41470
832,Sliggoo,-6,-18,-33,23,50,-43,-27,7056
833,Sliggoo (Hisuian Sliggoo),-16,-18,-3,23,50,-63,-27,8316
834,Goodra,16,7,-16,50,87,-23,121,25800
835,Goodra (Hisuian Goodra),6,7,14,50,87,-43,121,26840
836,Klefki,-17,-13,5,20,24,-28,-9,2324
837,Phantump,-31,-23,-38,-10,-3,-65,-170,36168
838,Trevenant,11,17,-10,5,19,-47,-5,3130
839,Pumpkaboo (Small Size),-30,-27,-16,-16,-8,-47,-144,25150
840,Pumpkaboo (Average Size),-25,-27,-16,-16,-8,-52,-144,25370
841,Pumpkaboo (Large Size),-20,-27,-16,-16,-8,-57,-144,25690
842,Pumpkaboo (Super Size),-15,-27,-16,-16,-8,-62,-144,26110
843,Gourgeist (Small Size),-19,-8,36,-2,12,-4,15,2110
844,Gourgeist (Average Size),-9,-3,36,-2,12,-19,15,2120
845,Gourgeist (Large Size),1,2,36,-2,12,-34,15,2830
846,Gourgeist (Super Size),11,7,36,-2,12,-49,15,4240
847,Bergmite,-19,-24,-1,-28,-28,-75,-175,38756
848,Avalugg,21,24,98,-16,-17,-75,35,18016
849,Avalugg (Hisuian Avalugg),21,34,98,-26,-27,-65,35,18056
850,Noibat,-34,-63,-51,-15,-23,-48,-234,65540
851,Noivern,11,-23,-6,37,17,20,56,5880
852,Xerneas,52,38,9,71,35,-4,201,50912
853,Yveltal,52,38,9,71,35,-4,201,50912
854,Zygarde (50% Forme),34,7,35,21,32,-8,121,18600
855,Zygarde (10% Forme),-20,7,-15,1,22,12,7,1352
856,Zygarde (Complete Forme),142,7,35,31,32,-18,229,76188
857,Diancie,-24,7,64,40,87,-53,121,31340
858,Diancie (Mega Diancie),-24,67,24,100,47,7,221,66740
859,Hoopa (Hoopa Confined),6,17,-26,90,67,-33,121,29320
860,Hoopa (Hoopa Unbound),6,67,-26,110,67,-23,201,62720
861,Volcanion,6,17,34,70,27,-33,121,22840
862,Rowlet,-6,-38,-31,-10,-13,-61,-159,31712
863,Dartrix,4,-18,-11,10,7,-51,-59,6692
864,Decidueye,4,14,-11,40,37,-33,51,6992
865,Decidueye (Hisuian Decidueye),14,19,-6,35,32,-43,51,7292
866,Litten,-29,-28,-46,0,-23,-33,-159,30640
867,Torracat,-9,-8,-36,20,-13,-13,-59,5660
868,Incineroar,21,22,4,20,27,-43,51,6520
869,Popplio,-24,-39,-32,6,-7,-63,-159,32456
870,Brionne,-14,-24,-17,31,18,-53,-59,8636
871,Primarina,6,-19,-12,66,53,-43,51,12156
872,Pikipek,-39,-18,-56,-30,-33,-38,-214,54210
873,Trumbeak,-19,-8,-36,-20,-13,-28,-124,18450
874,Toucannon,6,27,-11,15,12,-43,6,3140
875,Yungoos,-26,-23,-56,-30,-33,-58,-226,60770
876,Gumshoos,14,17,-26,-5,-3,-58,-61,8280
877,Grubbin,-27,-31,-41,-5,-18,-57,-179,39010
878,Charjabug,-17,-11,9,-5,12,-67,-79,11390
879,Vikavolt,3,-23,4,85,12,-60,21,11964
880,Crabrawler,-27,-11,-29,-18,-16,-40,-141,23752
881,Crabominable,23,39,-9,2,4,-60,-1,5752
882,Oricorio,1,-23,-16,38,7,-10,-3,2388
883,Cutiefly,-34,-48,-46,-5,-23,-19,-175,37116
884,Ribombee,-14,-38,-26,35,7,21,-15,4256
885,Rockruff,-29,-28,-46,-30,-23,-43,-199,46620
886,Lycanroc (Midday Form),1,22,-21,-5,2,9,8,1100
887,Lycanroc (Midnight Form),11,22,-11,-5,12,-21,8,1400
888,Lycanroc (Dusk Form),1,24,-21,-5,2,7,8,1160
889,Wishiwashi (Solo Form),-29,-73,-66,-35,-38,-63,-304,109580
890,Wishiwashi (School Form),-29,47,44,80,72,-73,141,41780
891,Mareanie,-24,-40,-24,-17,-11,-58,-174,36802
892,Toxapex,-24,-30,66,-7,79,-68,16,17002
893,Mudbray,-4,7,-16,-15,-8,-58,-94,12810
894,Mudsdale,26,32,14,-5,22,-68,21,7470
895,Dewpider,-36,-53,-34,-20,9,-76,-210,55618
896,Araquanid,-6,-23,6,-10,69,-61,-25,9808
897,Fomantis,-34,-38,-51,-10,-28,-68,-229,63150
898,Lurantis,-4,12,4,20,27,-58,1,4670
899,Morelull,-34,-58,-31,5,12,-88,-194,51030
900,Shiinotic,-14,-48,-6,30,37,-73,-74,15610
901,Salandit,-26,-49,-46,11,-23,-26,-159,31800
902,Salazzle,-6,-29,-26,51,-3,14,1,4360
903,Stufful,-4,-18,-36,-15,-13,-53,-139,24160
904,Bewear,46,32,-6,-5,-3,-43,21,5500
905,Bounsweet,-32,-63,-48,-30,-25,-71,-269,86224
906,Steenee,-22,-53,-38,-20,-15,-41,-189,42764
907,Tsareena,-2,27,12,-10,35,-31,31,4124
908,Comfey,-23,-41,4,22,47,-3,6,4964
909,Oranguru,16,-33,-6,30,47,-43,11,6460
910,Passimian,26,27,4,-20,-3,-23,11,2480
911,Wimpod,-49,-58,-46,-40,-33,-23,-249,73100
912,Golisopod,1,32,54,0,27,-63,51,11240
913,Sandygast,-19,-38,-6,10,-18,-88,-159,35290
914,Palossand,11,-18,24,40,12,-68,1,7390
915,Pyukumuku,-19,-33,44,-30,67,-98,-69,23140
916,Type: Null,21,2,9,35,32,-44,55,7736
917,Silvally,21,2,9,35,32,-8,91,11120
918,Minior (Meteor Form),-14,-33,14,0,37,-43,-39,6220
919,Minior (Core),-14,7,-26,40,-3,17,21,3260
920,Komala,-9,22,-21,15,32,-38,1,3700
921,Turtonator,-14,-15,49,31,22,-67,6,8792
922,Togedemaru,-9,5,-23,-20,10,-7,-44,3120
923,Mimikyu,-19,-3,-6,-10,42,-7,-3,2328
924,Bruxish,-6,12,-16,10,7,-11,-4,722
925,Drampa,4,-33,-1,75,28,-67,6,12040
926,Dhelmise,-4,38,14,26,27,-63,38,8474
927,Jangmo-o,-29,-38,-21,-15,-18,-58,-179,38680
928,Hakamo-o,-19,-18,4,5,7,-38,-59,5700
929,Kommo-o,1,17,39,40,42,-18,121,20140
930,Tapu Koko,-4,22,-1,35,12,27,91,10880
931,Tapu Lele,-4,-8,-11,70,52,-8,91,16150
932,Tapu Bulu,-4,37,29,25,32,-28,91,12940
933,Tapu Fini,-4,-18,29,35,67,-18,91,15500
934,Cosmog,-31,-64,-55,-31,-32,-66,-279,92264
935,Cosmoem,-31,-64,45,-31,68,-66,-79,23264
936,Solgaleo,63,44,21,53,26,-6,201,50268
937,Lunala,63,20,3,77,44,-6,201,52680
938,Nihilego,35,-40,-39,67,68,0,91,21740
939,Buzzwole,33,46,53,-7,-10,-24,91,15020
940,Pheromosa,-3,44,-49,77,-26,48,91,21536
941,Xurkitree,9,-4,-15,113,8,-20,91,21836
942,Celesteela,23,8,17,47,38,-42,91,14580
943,Kartana,-15,88,45,-1,-32,6,91,19336
944,Guzzlord,149,8,-33,37,-10,-60,91,36704
945,Necrozma,23,14,15,67,26,-24,121,21332
946,Necrozma (Dusk Mane Necrozma),23,64,41,53,46,-26,201,52308
947,Necrozma (Dawn Wings Necrozma),23,20,23,97,64,-26,201,56040
948,Necrozma (Ultra Necrozma),23,74,11,107,34,26,275,95032
949,Magearna,6,2,29,70,52,-38,121,24570
950,Marshadow,16,32,-6,30,27,22,121,18070
951,Poipole,-7,-20,-19,13,4,-30,-59,5376
952,Naganadel,-1,-20,-13,67,10,18,61,9204
953,Stakataka,-13,38,125,-7,38,-90,91,35112
954,Blacephalon,-21,34,-33,91,16,4,91,19520
955,Zeraora,14,19,-11,42,17,40,121,18972
956,Meltan,-28,-28,-21,-5,-28,-69,-179,39620
957,Melmetal,61,50,57,20,2,-69,121,29276
958,Grookey,-24,-28,-36,-20,-23,-38,-169,33590
959,Thwackey,-4,-8,-16,-5,-3,-23,-59,4380
960,Rillaboom,26,32,4,0,7,-18,51,4690
961,Scorbunny,-24,-22,-46,-20,-23,-34,-169,33822
962,Raboot,-9,-7,-26,-5,-3,-9,-59,4402
963,Cinderace,6,23,-11,5,12,16,51,3712
964,Sobble,-24,-53,-46,10,-23,-33,-169,35780
965,Drizzile,-9,-33,-31,35,-8,-13,-59,7070
966,Inteleon,-4,-8,-21,65,2,17,51,7640
967,Skwovet,-4,-38,-31,-25,-28,-78,-204,51530
968,Greedent,46,2,9,-5,12,-83,-19,9620
969,Rookidee,-36,-46,-51,-27,-28,-46,-234,64398
970,Corvisquire,-6,-26,-31,-17,-8,-26,-114,15698
971,Corviknight,24,-6,19,-7,22,-36,16,3058
972,Blipbug,-49,-73,-66,-35,-18,-58,-299,106400
973,Dottler,-24,-58,-6,-10,27,-73,-144,30870
974,Orbeetle,-14,-48,24,20,57,-13,26,7570
975,Nickit,-34,-65,-58,-13,-11,-53,-234,66600
976,Thievul,-4,-35,-28,27,29,-13,-24,4340
977,Gossifleur,-34,-53,-26,-20,-3,-93,-229,66140
978,Eldegoss,-14,-43,4,20,57,-43,-19,7920
979,Wooloo,-32,-53,-31,-20,-18,-55,-209,52224
980,Dubwool,-2,-13,14,0,27,-15,11,1444
981,Chewtle,-24,-29,-36,-22,-25,-59,-195,45328
982,Drednaw,16,22,4,-12,5,-29,6,1802
983,Yamper,-15,-48,-36,-20,-13,-77,-209,54004
984,Boltund,-5,-3,-26,30,-3,18,11,2064
985,Rolycoly,-44,-53,-36,-20,-13,-73,-239,69060
986,Carkol,6,-33,4,0,7,-53,-69,8760
987,Coalossal,36,-13,34,20,27,-73,31,10040
988,Applin,-34,-53,-6,-20,-23,-83,-219,59780
989,Flapple,-4,17,-6,35,-3,-33,6,2700
990,Appletun,36,-8,-6,40,17,-73,6,8650
991,Silicobra,-22,-36,-11,-25,-13,-57,-164,32840
992,Sandaconda,-2,14,39,5,7,-32,31,3780
993,Cramorant,-4,-8,-31,25,32,-18,-4,3030
994,Arrokuda,-33,-30,-46,-20,-33,-37,-199,46564
995,Barraskewda,-13,30,-26,0,-13,33,11,3124
996,Toxel,-34,-55,-51,-6,-28,-63,-237,67740
997,Toxtricity,1,5,-16,54,7,-28,23,4560
998,Sizzlipede,-24,-28,-41,-10,-13,-58,-174,36950
999,Centiskorch,26,22,-21,30,27,-38,46,6790
1000,Clobbopus,-24,-25,-26,-10,-13,-71,-169,35748
1001,Grapploct,6,25,4,10,17,-61,1,4788
1002,Sinistea,-34,-48,-41,14,-9,-53,-171,37468
1003,Polteageist,-14,-28,-21,74,51,-33,29,11428
1004,Hatenna,-32,-63,-41,-4,-10,-64,-214,56682
1005,Hattrem,-17,-53,-21,26,10,-54,-109,19112
1006,Hatterene,-17,-3,9,76,40,-74,31,14192
1007,Impidimp,-29,-48,-56,-5,-23,-53,-214,55440
1008,Morgrem,-9,-33,-41,15,-8,-33,-109,16110
1009,Grimmsnarl,21,27,-21,35,12,-43,31,5790
1010,Obstagoon,19,-3,15,0,18,-8,41,2664
1011,Perrserker,-4,17,14,-10,-3,-53,-39,4940
1012,Cursola,-14,2,-36,85,67,-73,31,19500
1013,Sirfetch'd,-12,42,9,8,19,-38,28,4642
1014,Mr. Rime,6,-8,-11,50,37,-33,41,6860
1015,Runerigus,-16,2,59,-10,42,-73,4,10950
1016,Milcery,-29,-53,-46,-10,-2,-69,-209,54312
1017,Alcremie,-9,-33,-11,50,58,-39,16,8932
1018,Falinks,-9,7,14,10,-3,-28,-9,1300
1019,Pincurchin,-26,8,9,31,22,-88,-44,11946
1020,Snom,-44,-68,-51,-15,-33,-83,-294,103800
1021,Frosmoth,-4,-28,-26,65,27,-38,-4,7890
1022,Stonjourner,26,32,49,-40,-43,-33,-9,8720
1023,Eiscue (Ice Face),1,-13,24,5,27,-53,-9,4390
1024,Eiscue (Noice Face),1,-13,-16,5,-13,27,-9,1430
1025,Indeedee (Male),-14,-28,-31,45,32,-8,-4,5070
1026,Indeedee (Female),-4,-38,-21,35,42,-18,-4,5230
1027,Morpeko,-16,2,-28,10,-5,-6,-43,3054
1028,Cufant,-2,-13,-37,-20,-14,-63,-149,28308
1029,Copperajah,48,37,-17,20,6,-73,21,10168
1030,Dracozolt,16,7,4,20,7,-28,26,2230
1031,Arctozolt,16,7,4,30,17,-48,26,4490
1032,Dracovish,16,-3,14,10,17,-28,26,2310
1033,Arctovish,16,-3,14,20,27,-48,26,4570
1034,Duraludon,-4,2,29,60,-13,-18,56,8090
1035,Dreepy,-46,-33,-56,-20,-33,-21,-209,51952
1036,Drakloak,-6,-13,-36,0,-13,-1,-69,6432
1037,Dragapult,14,27,-11,40,12,39,121,18952
1038,Zacian (Hero of Many Battles),18,27,29,20,52,35,181,38984
1039,Zacian (Crowned Sword),18,57,29,20,52,45,221,58384
1040,Zamazenta (Hero of Many Battles),18,27,29,20,52,35,181,38984
1041,Zamazenta (Crowned Shield),18,27,54,20,77,25,221,59764
1042,Eternatus,66,-8,9,85,32,27,211,58000
1043,Eternatus (Eternamax Eternatus),181,22,164,65,187,27,646,517380
1044,Kubfu,-14,-3,-26,-7,-13,-31,-94,10896
1045,Urshifu,26,37,14,3,-3,-6,71,7336
1046,Zarude,31,27,19,10,32,2,121,17820
1047,Regieleki,6,7,-36,40,-13,97,101,22760
1048,Regidrago,126,7,-36,40,-13,-23,101,29720
1049,Glastrier,26,52,44,5,47,-73,101,23080
1050,Spectrier,26,-28,-26,85,17,27,101,20580
1051,Calyrex,26,-13,-6,20,17,-23,21,2540
1052,Calyrex (Ice Rider Calyrex),26,72,64,25,67,-53,201,58280
1053,Calyrex (Shadow Rider Calyrex),26,-8,-6,105,37,47,201,55780
1054,Wyrdeer,29,12,-14,45,12,-38,46,6910
1055,Kleavor,-4,42,9,-15,7,-18,21,2900
1056,Ursaluna,56,47,19,-15,17,-53,71,14070
1057,Basculegion (Male),46,19,-21,20,12,-25,51,6688
1058,Basculegion (Female),46,-1,-21,40,12,-25,51,7528
1059,Sneasler,6,37,-26,-20,17,17,31,4020
1060,Overqwil,11,22,9,5,2,-18,31,2000
1061,Enamorus (Incarnate Forme),0,22,-16,75,17,3,101,16864
1062,Enamorus (Therian Forme),0,22,24,75,37,-57,101,21504
1063,Sprigatito,-34,-32,-32,-15,-18,-38,-169,33758
1064,Floragato,-13,-13,-23,0,0,-20,-69,6028
1065,Meowscarada,2,17,-16,21,7,20,51,4040
1066,Fuecoco,-7,-48,-27,3,-23,-67,-169,36670
1067,Crocalor,7,-38,-8,30,-5,-54,-68,10022
1068,Skeledirge,30,-18,14,50,12,-37,51,8034
1069,Quaxly,-19,-28,-41,-10,-18,-53,-169,34620
1070,Quaxwell,-4,-8,-21,5,-3,-38,-69,6760
1071,Quaquaval,11,27,-6,25,12,-18,51,4580
1072,Lechonk,-20,-48,-46,-25,-18,-68,-225,61018
1073,Oinkologne (Male),36,7,-11,-1,17,-38,10,3300
1074,Oinkologne (Female),41,-3,-16,-1,27,-38,10,4220
1075,Tarountula,-39,-52,-41,-31,-23,-83,-269,86646
1076,Spidops,-14,-14,6,-8,23,-68,-75,11270
1077,Nymble,-41,-47,-46,-39,-38,-58,-269,84696
1078,Lokix,-3,9,-8,-8,-8,-11,-29,1244
1079,Pawmi,-29,-43,-66,-20,-38,-43,-239,67860
1080,Pawmo,-14,-18,-46,-10,-23,-18,-129,20230
1081,Pawmot,-4,22,-16,10,-3,2,11,990
1082,Tandemaus,-24,-43,-41,-20,-18,-28,-174,35890
1083,Maushold,0,-18,-16,5,12,8,-9,894
1084,Fidough,-37,-38,-16,-30,-8,-38,-167,33366
1085,Dachsbun,-17,-13,29,-10,17,-8,-2,1756
1086,Smoliv,-33,-58,-41,-2,-12,-73,-219,59572
1087,Dolliv,-22,-40,-26,18,15,-70,-125,23834
1088,Arboliva,4,-24,4,65,46,-64,31,12006
1089,Squawkabilly,8,3,-35,-15,-12,-11,-62,5632
1090,Nacli,-19,-38,-11,-25,-28,-78,-199,49020
1091,Naclstack,-14,-33,14,-25,2,-68,-124,22110
1092,Garganacl,26,7,44,-15,27,-68,21,8680
1093,Charcadet,-34,-43,-46,-10,-23,-68,-224,60550
1094,Armarouge,11,-33,14,65,17,-28,46,8820
1095,Ceruledge,1,32,-6,0,37,-18,46,4870
1096,Tadbulb,-13,-62,-45,-1,-28,-58,-207,53036
1097,Bellibolt,35,-29,5,43,20,-58,16,7960
1098,Wattrel,-34,-53,-51,-5,-23,-33,-199,47810
1099,Kilowattrel,-4,-23,-26,45,-3,22,11,3860
1100,Maschiff,-14,-15,-26,-20,-12,-52,-139,23666
1101,Mabosstiff,6,27,4,0,7,-18,26,1830
1102,Shroodle,-34,-28,-51,-20,-28,-28,-189,42230
1103,Grafaiai,-11,2,-21,20,9,7,6,1132
1104,Bramblin,-34,-28,-56,-15,-28,-43,-204,49550
1105,Brambleghast,-19,22,-16,20,7,-13,1,1720
1106,Toedscool,-34,-53,-51,-10,37,-33,-144,29860
1107,Toedscruel,6,-23,-21,20,57,-3,36,5960
1108,Klawf,-4,7,29,-25,-8,-28,-29,3220
1109,Capsakid,-24,-31,-46,2,-23,-53,-175,37620
1110,Scovillain,-9,15,-21,48,2,-28,7,3888
1111,Rellor,-33,-43,-26,-29,-5,-73,-209,53490
1112,Rabsca,1,-43,-1,55,37,-58,-9,9690
1113,Flittle,-44,-58,-56,-5,-33,-28,-224,60510
1114,Espathra,21,-33,-26,41,-3,2,2,3904
1115,Tinkatink,-24,-48,-41,-25,1,-45,-182,40336
1116,Tinkatuff,-9,-38,-31,-15,19,-25,-99,13498
1117,Tinkaton,11,-18,-9,10,42,-9,27,3200
1118,Wiglett,-64,-38,-61,-25,-38,-8,-234,66150
1119,Wugtrio,-39,7,-36,-10,7,17,-54,6220
1120,Bombirdier,-4,10,-1,0,22,-21,6,1078
1121,Finizen,-4,-48,-46,-15,-23,-28,-164,32870
1122,Palafin,26,-23,-14,-7,-1,-3,-22,1944
1123,Palafin,26,67,11,46,24,-3,171,37228
1124,Varoom,-29,-23,-23,-30,-18,-56,-179,38300
1125,Revavroom,6,26,4,-6,4,-13,21,1390
1126,Cyclizar,-4,2,-21,25,2,18,22,1898
1127,Orthworm,-4,-8,59,0,-8,-38,1,5070
1128,Glimmet,-26,-58,-44,45,-3,-43,-129,26500
1129,Glimmora,9,-38,4,70,18,-17,46,9170
1130,Greavard,-24,-32,-26,-30,-8,-69,-189,43722
1131,Houndstone,-2,8,14,-10,34,-35,9,2826
1132,Flamigo,8,22,-12,15,1,-13,21,1528
1133,Cetoddle,34,-25,-41,-30,-23,-60,-145,29516
1134,Cetitan,96,20,-21,-15,-8,-30,42,13010
1135,Veluza,16,9,-13,18,2,-33,-1,1924
1136,Dondozo,76,7,29,5,2,-68,51,13920
1137,Tatsugiri,-6,-43,-26,60,32,-21,-4,7642
1138,Annihilape,36,22,-6,-10,27,-13,56,5950
1139,Clodsire,56,-18,-26,-15,37,-83,-49,15020
1140,Farigiraf,46,-3,-16,50,7,-43,41,8460
1141,Dudunsparce,51,7,-6,25,12,-48,41,7440
1142,Kingambit,26,42,34,0,22,-53,71,11930
1143,Great Tusk,41,38,45,-7,-10,-16,91,13836
1144,Scream Tail,41,-28,13,5,52,8,91,13708
1145,Brute Bonnet,37,34,13,19,36,-48,91,14936
1146,Flutter Mane,-19,-38,-31,75,72,32,91,22880
1147,Slither Wing,11,42,-7,25,42,-22,91,13088
1148,Sandy Shocks,11,-12,11,61,22,-2,91,12876
1149,Iron Treads,16,19,34,12,7,3,91,10256
1150,Iron Bundle,-18,-13,28,64,-3,33,91,14752
1151,Iron Hands,80,47,22,-10,5,-53,91,20308
1152,Iron Jugulis,20,-13,0,62,17,5,91,13008
1153,Iron Moth,6,-23,-26,80,47,7,91,18180
1154,Iron Thorns,26,41,24,10,21,-31,91,12716
1155,Frigibax,-9,-18,-41,-25,-18,-48,-159,30620
1156,Arctibax,16,2,-20,-15,2,-41,-56,5706
1157,Baxcalibur,41,52,6,15,23,-16,121,20072
1158,Gimmighoul (Chest Form),-29,-63,-16,15,7,-93,-179,46030
1159,Gimmighoul (Roaming Form),-29,-63,-61,15,-18,-23,-179,41650
1160,Gholdengo,13,-33,9,73,28,-19,71,12854
1161,Wo-Chien,11,-8,14,35,72,-33,91,16160
1162,Chien-Pao,6,27,-6,30,2,32,91,11010
1163,Ting-Lu,81,17,39,-5,17,-58,91,20330
1164,Chi-Yu,-19,-13,-6,75,57,-3,91,17730
1165,Roaring Moon,31,46,-15,-5,38,16,111,17348
1166,Iron Valiant,0,37,4,60,-3,13,111,17484
1167,Koraidon,26,42,29,25,37,32,191,42780
1168,Miraidon,26,-8,14,75,52,32,191,46770
